11111111111111111111111111111111111111111111111
1********000C000M00000M***C**000000000000000001
1CM000000011111111111111111********0000MC0000C1
11111110000******00000M00C0000000****1111000111
1*****00000111111*****111111********00000000001
1000******0000000001111000000***11110000000**01
1P000000000000000**********************1111**C1
11111111111111111000000000000000000000000000111
10000000000000000000000000000000000000000000001
1CM0M*****00000******000C0000****00000000000001
11111111****000000***1111110000000***0001111111
1*******0000CM0000******C******M111111111111111
1****111111111111111111111111111111111111111111
100000000C111111110C0111110C0111110C00000000C11
111111***M*********************************1111
1C0000001111111111111111111111111111*********E1
11111111111111111111111111111111111111111111111
