11111111111111111111111111111111111111111111111
10000000000000000000000000000000000000000000001
1********000C000M00000M***C**000000000000000001
1CM000000011111111111111111111*****0000MC0000C1
11111111000**M***00000M00C0000000****1111001111
1*****000111111110****000000********00000000001
1000******0000000001111000000***11111000000**01
1P0000E0000000000**********************1111**C1
11111111111111111110000000000000000000000000111
11111111111111111111111111111111111111111111111
